PPPPPPPPPPPP
P.......CM.P
P...A......P
P.P.....P..P
P.....M..U.P
P.P.P.P.P..P
P1......M..P
P.P.P.P.P..P
P........C.P
PPPPPPPPPPPP