MMMMMMMMMMMM
M1#C#######M
M###A######M
M##########M
M##########M
M##########M
M##########M
M##########M
M##########M
MMMMMMMMMMMM