PPPPPPPPPPPPPPPPPPPPPPPP
P.......CM........PL.PMP
P.V.A...........M...L..P
P.P.L..LP...PLPP..C....P
P.....M..U....P..V.M.A.P
P.P.P.P.P..P...L.C...L.P
P1......M....A.....U...P
P.P.P.P.P......LLL.....P
P.U..V...C......M...V..P
PPPPPPPPPPPPPPPPPPPPPPPP