MMMMMMMMMMMM
M##########M
M###A######M
M#M#####M##M
M##########M
M#M#M#M#M##M
M1#########M
M#M#M#M#M##M
M########C#M
MMMMMMMMMMMM