PPPPPPPPPPPP
P.......CM.P
P.V.A......P
P.P.LLLLP..P
P.....M..U.P
P.P.P.P.P..P
P1......M..P
P.P.P.P.P..P
P....V...C.P
PPPPPPPPPPPP