PPPPPPPPPPPP
P........M.P
P...A......P
P.P.....P..P
P.....M....P
P.P.P.P.P..P
P1......M..P
P.P.P.P.P..P
P........C.P
PPPPPPPPPPPP